{
	"tileset" : "chemin.png",
	"ground" : [
		[2,2,2,2,2,10,2,2,2,2,2,2,2,2,2,2,2,2,2,2,2,2,2,2,2],
        [2,2,2,2,2,10,2,2,2,2,2,2,2,2,2,2,2,2,2,2,2,2,2,2,2],
        [2,2,2,2,2,10,2,2,2,2,2,2,2,2,2,2,2,2,2,2,2,2,2,2,2],
        [2,2,2,2,2,10,2,2,2,2,2,2,2,2,2,2,2,2,2,2,2,2,2,2,2],
        [2,2,2,2,2,10,10,10,10,10,10,2,2,2,2,2,2,2,2,10,10,10,10,10,2],
        [2,2,2,2,2,2,2,2,2,2,10,2,2,2,2,2,2,2,2,10,2,2,2,2,2],
        [2,2,2,2,2,2,2,2,2,2,10,2,2,2,2,2,2,2,2,10,2,2,2,2,2],
        [2,2,2,2,2,2,2,2,2,2,10,10,10,10,10,10,10,10,10,10,2,2,2,2,2],
        [2,2,2,2,2,2,2,2,2,2,10,2,2,2,2,2,2,2,2,2,2,2,2,2,2],
        [2,2,2,2,2,2,2,2,2,2,10,2,2,2,2,2,2,2,2,2,2,2,2,2,2],
        [2,2,2,2,10,10,10,10,10,10,10,2,2,2,2,2,2,2,2,2,2,2,2,2,2],
        [2,2,2,2,10,2,10,2,2,2,10,2,2,2,10,10,10,10,10,10,10,10,10,10,2],
        [2,2,2,2,10,2,10,2,2,2,10,2,2,2,10,2,2,2,2,2,2,2,2,10,2],
        [2,2,2,2,10,2,10,2,2,2,10,2,2,2,10,2,2,2,2,10,10,10,2,10,2],
        [2,2,2,2,10,2,10,2,2,2,10,2,2,2,10,2,2,2,2,10,2,10,2,10,2],
        [2,2,2,2,10,2,10,2,2,2,10,2,2,2,10,2,2,2,2,10,2,10,2,10,2],
        [2,2,2,2,10,2,10,2,2,2,10,2,2,2,10,2,2,2,2,10,2,10,2,10,2],
        [2,2,2,2,10,2,10,2,2,2,10,2,2,2,10,2,2,2,2,10,2,10,2,10,2],
        [2,2,2,2,2,2,2,2,2,2,10,2,2,2,10,2,2,2,2,10,2,10,10,10,2],
        [2,2,2,2,2,2,2,2,2,2,10,2,2,2,10,2,2,2,2,10,2,2,2,2,2],
        [2,2,2,2,2,2,2,2,2,2,10,2,2,2,10,2,2,2,2,10,10,10,10,10,2],
        [2,2,2,2,2,2,2,2,2,2,10,10,10,10,10,2,2,2,2,2,2,2,2,2,2],
        [2,2,2,2,2,2,2,2,2,10,10,2,2,2,2,2,2,2,2,2,2,2,2,2,2],
        [2,2,2,2,2,2,2,2,2,10,2,2,2,2,2,2,2,2,2,2,2,2,2,2,2],
        [2,10,10,10,10,10,10,10,10,10,2,2,2,2,2,2,2,2,2,2,2,2,2,2,2],
        [2,10,2,2,2,2,2,2,2,2,2,2,2,2,2,2,2,2,2,2,2,2,2,2,2],
        [2,10,2,2,2,2,2,2,2,2,2,2,2,2,2,2,2,2,2,2,2,2,2,2,2],
        [2,10,2,2,2,2,2,2,2,2,2,2,2,2,2,2,2,2,2,2,2,2,2,2,2],
        [2,10,2,2,2,2,2,2,2,10,10,10,10,10,10,10,10,2,2,2,2,2,2,2,2],
        [2,10,10,10,10,10,10,10,10,10,2,2,2,2,2,2,10,2,2,2,2,2,2,2,2],
        [2,10,2,2,2,2,2,2,2,2,2,2,2,2,2,2,2,2,2,2,2,2,2,2,2],
        [2,10,2,2,2,2,2,2,2,2,2,2,2,2,2,2,2,2,2,2,2,2,2,2,2],
        [2,10,2,2,2,2,2,2,2,10,2,2,2,2,2,2,2,2,2,2,2,2,2,2,2],
        [2,10,10,10,10,10,10,10,10,10,10,10,10,10,10,10,10,10,10,10,10,10,10,10,10],
        [2,2,2,2,2,2,2,2,2,2,2,2,2,2,2,2,2,2,2,2,2,2,2,2,2]
	],
    "invalidFrame": [2],
    "start": {
        "x": 5,
        "y": 0
    },
	"end": {
		"x": 24,
		"y": 33
	}
}
