{
	"tileset" : "chemin.png",
	"ground" : [
		[2,2,2,2,2,2,2,2,2,2,2,2,2],
		[2,2,10,10,10,10,10,2,2,2,2,2,2],
		[2,2,10,2,2,2,10,2,2,2,2,2,2],
		[2,2,10,10,2,2,10,2,2,2,2,2,2],
		[2,2,2,10,2,2,10,2,2,2,2,2,2],
		[2,10,10,10,2,2,10,2,2,2,2,2,2],
		[2,10,2,2,2,2,10,2,2,2,2,2,2],
		[2,10,2,2,2,2,10,2,2,2,2,2,2],
		[2,10,10,2,2,2,10,2,2,2,2,2,2],
		[2,2,10,2,2,2,10,2,2,2,2,2,2],
		[2,10,10,2,2,2,10,10,10,10,10,10,2],
		[2,2,2,2,2,2,2,2,2,2,2,10,2],
		[2,2,2,2,2,2,2,2,2,2,2,10,2],
		[2,2,2,2,2,2,2,2,2,2,2,10,2],
		[2,2,2,2,2,2,2,2,2,2,2,10,2],
		[2,2,2,2,2,2,2,2,2,2,2,10,2],
		[2,2,2,2,2,2,10,10,10,10,10,10,2],
		[2,2,2,2,2,2,10,2,2,2,2,2,2],
		[2,2,2,2,2,2,10,2,2,2,2,2,2],
		[2,2,2,2,2,2,10,2,2,2,2,2,2],
		[2,10,10,10,10,2,10,10,10,10,2,2,2],
		[2,2,2,2,10,2,2,2,2,10,2,2,2],
		[2,2,2,10,10,2,2,2,2,10,2,2,2],
		[2,10,10,10,2,2,2,2,2,10,2,2,2],
		[2,10,2,2,2,2,2,2,2,10,2,2,2],
		[2,10,10,10,10,2,10,10,10,10,2,2,2],
		[2,2,2,2,10,2,10,2,2,2,2,2,2],
		[2,2,2,10,10,2,10,10,2,2,2,2,2],
		[2,2,2,10,2,2,2,10,2,2,2,2,2],
		[2,2,2,10,10,10,10,10,2,2,2,2,2],
		[2,2,2,2,2,2,2,2,2,2,2,2,2]
	],
	"invalidFrame": [2],
	"start": {
		"x": 1,
		"y": 20
	},
	"end": {
		"x": 1,
		"y": 10
	}
}
