{
	"tileset" : "chemin.png",
	"ground" : [
		[10,10,10,2,2,2,2,2,2,2,2,2,2,2,2,2],
        [2,2,10,2,2,2,2,2,2,2,2,2,2,2,2,2],
        [2,2,10,2,2,2,2,2,2,2,2,2,2,2,2,2],
        [10,10,10,10,10,10,10,2,2,2,2,2,2,2,2,2],
        [10,2,10,2,2,2,10,2,2,2,2,2,2,2,2,2],
        [10,2,10,2,2,2,10,10,10,2,2,2,2,2,2,2],
        [10,2,10,2,2,2,2,2,10,2,2,2,2,2,2,2],
        [10,2,10,2,2,2,2,2,10,10,10,10,10,10,10,2],
        [2,2,10,2,2,2,2,2,2,2,2,2,2,2,2,2],
        [2,2,2,2,2,2,2,2,2,2,2,2,2,2,2,2]
	],
    "invalidFrame": [2],
    "start": {
        "x": 0,
        "y": 0
    },
	"end": {
		"x": 14,
		"y": 7
	}
}
